122
9
0 0 0 0 0 0 0 0 0 0 0 0 0 0 0 0 0 0 0 4 4 4 4 4 0 0 0 0 0 0 0 0 0 0 0 0 0 0 0 0 0 0 0 0 0 0 0 0 0 0 0 0 0 0 0 0 0 0 0 0 0 0 0 0 0 0 0 0 0 0 0 0 0 0 7 7 7 7 7 7 7 7 7 7 7 7 7 7 7 7 7 7 7 7 7 7 7 7 7 7 7 7 7 7 7 7 7 7 7 7 7 7 7 7 7 7 7 7 7 7 7 7
0 0 0 0 0 0 0 0 0 0 0 0 0 0 0 0 0 0 0 4 4 4 4 4 0 0 0 0 0 0 0 2 0 0 0 0 0 0 0 0 0 0 0 0 0 0 0 0 2 0 2 0 0 0 0 0 0 0 0 0 0 0 0 0 0 0 0 0 0 0 0 0 0 0 0 0 6 0 0 0 0 0 0 0 0 0 0 0 0 0 0 0 0 0 0 0 0 0 0 0 0 0 0 0 0 0 0 0 0 0 0 0 0 0 0 0 0 0 0 0 0 8
0 0 0 0 0 0 2 0 0 0 0 0 0 0 0 0 0 0 0 4 4 4 4 4 0 0 0 0 0 8 0 1 0 0 8 0 0 0 0 0 0 0 0 0 0 0 2 0 1 0 1 0 2 0 0 0 0 0 0 0 0 0 0 0 0 0 0 0 0 0 0 0 0 0 8 0 6 0 0 0 0 0 0 0 0 0 0 0 0 0 0 0 0 0 0 0 0 0 0 0 0 0 0 0 0 0 0 0 0 0 0 0 0 0 0 0 0 0 0 0 0 8
0 0 0 0 0 0 4 0 0 0 0 0 0 0 0 0 0 0 0 4 4 4 4 4 0 0 0 0 0 7 7 7 7 8 0 0 0 0 0 0 0 0 0 0 0 0 1 0 1 0 1 0 1 0 0 0 0 0 0 0 0 0 0 0 0 0 0 8 0 0 0 0 0 8 8 6 6 0 0 0 0 0 0 0 0 0 0 0 0 0 0 5 5 5 5 5 5 8 8 0 0 0 0 0 0 0 0 0 0 0 0 0 0 0 0 0 0 0 0 0 0 8
0 0 0 0 0 0 3 0 0 0 0 0 0 0 0 0 0 0 0 4 4 4 4 4 0 0 0 0 9 7 0 0 0 7 7 0 0 0 0 0 0 0 0 0 0 0 1 0 1 0 1 0 1 0 0 0 0 0 0 0 0 0 0 0 0 0 8 0 0 0 0 0 0 0 8 0 0 0 0 0 0 0 0 0 0 5 5 5 5 5 5 8 8 5 0 0 0 0 0 5 5 5 5 8 8 0 0 0 0 0 0 0 0 0 0 0 0 0 0 0 0 8
0 0 0 0 0 0 3 0 0 2 0 0 0 0 0 0 0 0 0 4 4 8 4 4 0 0 0 7 7 0 0 0 0 0 0 7 0 0 0 8 0 0 0 0 0 0 1 0 4 0 4 0 1 0 0 0 0 0 0 0 0 0 0 8 8 0 0 0 0 0 0 0 0 0 8 0 0 0 0 0 5 5 5 5 5 0 8 0 0 0 0 0 0 0 5 5 5 0 0 0 0 0 0 0 0 5 5 5 5 8 8 0 0 0 0 0 0 0 0 0 0 8
0 0 0 0 0 0 3 0 0 1 0 0 0 0 0 0 0 0 0 4 4 8 4 4 0 0 7 0 0 0 0 0 0 0 0 0 0 0 0 8 8 0 0 0 0 0 3 3 3 3 3 3 3 0 0 0 0 0 0 0 0 8 0 0 0 0 0 0 0 0 0 0 8 8 8 0 0 0 0 5 8 0 0 0 0 0 0 5 5 5 5 5 5 0 8 8 8 5 0 0 0 0 0 0 0 0 0 0 0 0 0 5 5 5 5 8 0 0 0 0 0 8
0 0 0 0 0 7 7 0 0 1 0 0 0 0 0 0 0 0 9 4 4 8 7 4 0 8 0 0 0 0 0 0 0 0 0 0 0 0 8 8 8 0 0 0 0 0 3 4 4 4 4 4 3 0 0 8 0 0 0 0 0 8 0 0 0 0 0 0 8 0 0 0 0 0 8 0 0 5 5 5 0 0 5 0 0 5 5 0 5 5 5 0 5 5 5 5 5 5 5 5 5 5 5 5 5 5 5 5 5 5 0 0 0 0 0 0 5 5 5 0 0 8
7 7 7 7 7 7 7 7 7 7 7 7 7 7 7 7 7 7 7 7 7 7 7 7 7 7 7 7 7 7 7 7 7 7 7 7 7 7 7 7 7 7 7 7 7 7 7 7 7 7 7 7 7 7 0 0 0 0 0 0 0 0 0 0 0 0 0 0 0 0 0 0 0 0 7 7 7 7 7 7 7 7 7 7 7 7 7 7 7 7 7 7 7 7 7 7 7 7 7 7 7 7 7 7 7 7 7 7 7 7 7 7 7 7 7 7 7 7 7 7 7 7